1111111111111
10P0000000001
10E000000C001
1111111111111