1111111111111
10P00000CC001
10E00000CC0N1
1111111111111